17 17 17 17 17 17 17 17 17 17 17 17 17 17 17 17 17 17 17 17 17 17 17 17 17 17 17 17 17 17 17 17 17 17 17 17 17 17 17 17 17 17 17 17 17 17 17 17 17 17 
17 17 17 17 17 17 17 17 17 17 17 17 2 2 2 2 2 17 17 17 17 17 17 17 17 17 17 17 17 17 17 17 17 17 17 17 17 17 17 17 17 17 17 17 17 17 17 17 17 17 
17 17 17 17 2 2 2 0 2 2 17 17 2 2 0 0 2 17 17 17 17 17 17 17 17 17 17 13 17 17 17 17 17 17 17 17 17 17 17 17 17 17 17 17 17 17 17 17 17 17 
17 17 17 17 2 2 2 2 2 2 0 2 2 2 0 0 2 17 17 17 17 17 17 17 17 17 2 2 2 2 2 2 2 17 17 17 17 17 17 17 17 17 17 17 17 17 17 17 17 17 
17 17 17 17 2 2 2 2 2 2 17 17 2 2 2 2 2 17 17 17 17 17 17 17 17 17 2 2 2 2 2 2 2 13 17 17 17 17 17 17 17 17 17 17 17 17 17 17 17 17 
17 17 17 17 2 2 2 2 2 2 17 17 2 2 2 2 2 17 17 17 17 17 17 0 17 17 2 2 2 0 2 2 2 17 17 17 13 17 17 17 17 17 17 0 17 17 17 17 17 17 
17 17 2 2 2 2 2 2 2 2 17 17 17 17 17 17 17 17 17 13 2 2 2 2 2 2 2 2 2 0 2 2 2 2 2 2 2 2 2 2 17 17 2 2 2 2 2 17 17 17 
17 17 2 2 2 2 2 2 2 2 17 17 17 17 17 17 17 17 17 17 2 2 2 2 2 2 2 2 2 0 2 2 2 2 2 2 2 2 2 2 2 0 2 2 2 2 2 17 17 17 
17 17 2 2 2 2 2 2 2 2 17 17 17 2 2 2 2 2 2 17 2 2 2 2 2 2 2 2 2 0 2 2 2 2 2 2 2 2 2 2 2 0 2 2 2 2 2 17 17 17 
17 17 2 2 2 2 2 2 2 2 17 17 17 2 2 2 2 2 2 17 2 2 2 2 1 1 2 2 2 0 2 2 2 1 1 2 2 2 2 2 2 0 2 2 2 2 2 17 17 17 
17 17 2 2 2 2 2 2 2 2 2 2 17 2 2 17 17 2 2 17 17 17 17 17 1 1 2 2 2 0 2 2 2 1 1 2 2 2 2 2 2 0 2 2 2 2 2 0 17 17 
17 17 2 2 2 2 2 2 2 2 2 2 17 2 2 17 17 2 2 17 2 2 2 2 2 2 2 2 2 0 2 2 2 2 2 2 2 2 2 2 17 17 2 2 2 2 2 17 17 17 
17 17 17 17 2 2 2 2 2 2 2 2 17 2 2 17 17 2 2 17 2 2 2 2 2 2 2 2 2 0 13 2 2 2 2 2 2 2 2 2 0 17 17 17 13 17 17 17 17 17 
17 17 17 17 2 2 2 2 2 2 2 2 2 2 2 17 17 2 2 0 2 2 2 2 2 2 2 2 2 0 2 2 2 2 2 2 2 2 2 2 17 17 17 17 17 17 17 17 17 17 
17 17 17 17 2 2 2 2 2 2 2 2 17 2 2 17 17 2 2 17 2 2 2 2 1 0 2 2 2 0 2 2 2 1 1 2 2 2 2 2 17 17 17 17 0 0 0 0 0 0 
17 17 17 17 2 2 2 2 2 2 2 2 17 17 17 17 17 17 17 17 2 2 2 2 1 1 2 2 2 0 2 2 2 1 1 2 2 2 2 2 17 17 17 0 0 0 0 0 0 0 
17 17 17 17 2 2 2 2 2 2 2 2 17 17 17 17 17 17 17 13 2 2 2 2 2 2 2 2 2 0 2 2 2 2 2 2 2 2 2 2 13 17 0 0 0 0 18 18 18 18 
17 17 17 17 17 17 17 0 17 17 17 17 17 17 17 17 17 17 17 17 2 2 2 2 2 2 2 2 2 0 2 2 2 2 2 2 2 2 2 2 17 17 0 0 0 18 18 18 18 18 
2 2 2 2 2 2 2 2 2 2 2 2 17 17 17 17 17 17 17 17 17 17 17 17 17 17 17 17 17 0 17 17 17 17 17 17 17 17 17 17 17 17 0 18 18 18 18 18 18 18 
2 2 2 2 2 2 2 2 2 2 2 2 17 17 17 17 17 17 17 17 17 17 17 17 17 17 17 17 17 0 17 17 17 17 17 17 17 0 0 0 0 18 18 18 18 18 18 18 18 18 
2 2 2 2 2 2 2 2 2 2 2 2 17 17 17 17 17 17 17 17 17 17 17 17 17 17 17 17 17 0 17 17 17 17 17 17 17 18 18 18 18 18 18 18 18 18 18 18 18 18 
2 2 2 2 2 2 2 2 2 2 2 2 17 17 17 17 17 17 17 17 17 17 17 17 17 17 17 17 17 0 17 17 17 17 17 17 17 20 18 18 18 18 18 18 18 18 18 18 18 18 
2 2 2 2 2 2 2 2 2 2 2 2 17 17 17 17 17 17 17 17 17 17 17 17 0 0 0 0 0 0 5 5 0 1 1 1 1 20 20 18 18 18 18 18 18 18 18 18 18 1 
2 2 2 2 2 2 2 2 2 2 2 2 0 17 17 17 17 17 17 17 17 17 17 0 0 0 0 18 18 5 5 5 18 18 1 1 1 20 20 20 18 18 18 18 18 18 18 18 1 1 
2 2 2 2 2 2 2 2 2 2 2 20 17 17 17 17 17 17 17 17 17 17 0 0 0 18 18 18 5 5 5 18 18 18 1 1 1 1 1 20 20 18 18 18 18 18 18 18 0 1 
2 2 2 2 2 2 2 2 2 2 2 20 17 17 17 17 17 17 17 17 1 13 0 0 18 18 18 18 5 5 18 18 18 18 1 18 18 20 0 20 20 18 18 18 18 18 18 18 1 1 
2 2 2 2 2 2 2 2 2 2 20 20 17 17 17 17 17 17 17 1 19 1 0 18 18 18 18 18 18 18 18 18 18 18 18 18 18 20 1 1 20 20 18 18 18 18 18 1 1 1 
2 2 2 0 0 2 2 2 2 20 20 20 17 17 17 17 17 17 1 19 19 19 19 18 18 18 18 18 18 18 18 18 18 18 1 18 20 20 1 1 1 20 20 18 18 18 1 1 1 1 
2 2 2 0 0 2 2 20 20 20 20 17 17 17 17 17 17 1 19 13 1 1 19 19 18 18 18 18 18 18 18 18 18 18 1 20 20 20 1 1 1 1 1 1 1 1 1 1 1 1 
2 2 2 2 2 2 20 20 20 20 17 17 17 17 17 17 1 19 0 0 0 0 1 19 19 1 18 18 18 18 18 18 1 13 1 20 20 20 1 1 1 1 1 0 1 13 1 1 1 1 
2 2 2 20 20 20 20 20 20 17 17 17 17 17 17 1 19 0 0 0 18 18 18 1 19 19 1 18 18 18 18 18 1 1 1 20 20 20 1 1 1 1 20 20 20 20 20 1 1 1 
17 17 17 17 17 17 17 17 17 17 17 17 17 17 1 1 19 0 0 18 18 18 18 18 18 18 18 18 18 18 18 18 1 1 1 20 20 20 20 1 20 20 20 20 20 20 20 20 20 1 
17 17 17 17 17 17 17 17 17 17 17 17 17 1 19 19 0 0 18 18 18 18 18 18 18 18 18 18 18 13 18 18 1 1 1 20 20 20 20 0 20 20 20 20 20 20 20 20 20 13 
17 17 17 17 17 17 17 17 17 17 17 17 5 19 5 5 5 0 18 18 18 18 18 18 18 18 18 18 18 18 18 20 13 1 1 20 20 20 20 1 20 20 20 20 1 1 20 20 20 1 
17 17 17 17 17 17 17 17 17 17 17 5 5 5 5 5 5 18 18 18 18 18 18 18 18 18 18 18 18 18 20 20 1 1 1 1 1 1 1 1 20 20 20 20 20 20 20 20 20 1 
17 17 17 17 17 17 17 17 17 17 5 5 5 5 5 1 1 1 0 1 1 1 1 1 1 1 1 0 1 1 1 1 1 1 1 1 1 1 1 1 20 20 20 20 20 20 20 20 20 1 
17 17 17 17 17 17 17 17 17 5 5 5 5 5 1 1 1 18 18 18 1 1 1 1 1 1 1 1 1 1 1 1 1 1 1 1 1 1 1 1 1 20 20 20 20 20 20 20 20 1 
17 17 17 17 17 17 17 17 0 0 5 5 5 1 1 18 18 18 18 18 18 18 1 1 1 1 1 1 1 13 1 1 1 1 1 1 1 1 1 1 1 1 1 1 1 20 20 20 1 1 
17 17 17 17 17 17 17 0 0 0 0 18 5 1 1 18 18 18 18 18 18 18 18 18 18 18 18 18 20 20 20 1 1 1 1 1 1 1 1 1 1 1 1 1 1 20 20 20 1 1 
17 17 17 17 17 17 0 0 18 18 18 18 18 1 18 18 18 18 1 18 18 18 18 18 18 18 20 20 20 20 20 1 1 1 1 1 1 1 1 1 1 1 1 1 1 20 20 20 1 1 
17 17 17 17 17 0 0 18 18 18 18 18 18 0 18 18 18 1 1 1 18 18 18 18 18 20 20 20 20 20 20 1 1 1 1 1 1 1 1 1 1 1 1 1 1 20 20 20 1 1 
17 17 17 17 0 0 18 18 18 18 18 18 18 1 18 18 18 18 1 18 18 18 1 1 1 1 1 1 1 0 1 1 13 1 1 1 1 19 19 1 0 19 13 19 1 20 20 20 13 1 
17 17 17 0 0 18 18 18 18 18 18 18 18 1 1 18 18 18 18 18 18 20 13 1 1 1 1 1 18 18 18 18 18 18 1 1 0 19 18 18 18 0 0 19 1 20 20 20 1 1 
17 17 0 0 18 18 18 18 18 18 18 18 18 1 1 18 18 18 20 20 20 20 1 1 1 1 1 1 0 18 18 18 18 18 18 18 18 18 18 18 18 18 0 0 1 20 20 20 1 1 
17 5 0 18 18 18 18 18 18 18 18 18 18 1 1 13 1 20 20 20 1 1 1 1 5 1 1 13 0 0 18 18 18 18 18 18 18 18 18 18 18 18 18 0 0 20 20 20 1 1 
5 5 0 18 18 18 18 18 18 18 18 18 5 5 1 1 1 1 0 1 1 1 1 5 5 5 1 1 0 0 0 0 18 18 19 19 1 19 18 18 18 18 18 0 1 20 20 1 1 1 
5 5 18 0 0 18 18 18 18 18 18 5 5 5 5 5 5 1 1 1 1 1 5 5 5 5 1 19 19 0 19 1 1 19 19 1 1 1 18 18 18 18 0 0 1 1 1 1 1 1 
5 5 18 0 0 18 18 18 18 5 5 5 5 5 5 5 5 5 5 5 5 5 5 5 5 5 5 5 5 5 5 5 5 5 5 5 5 19 18 18 18 0 0 19 1 1 1 1 1 1 
5 5 18 18 18 18 18 5 5 5 5 5 5 5 5 5 5 5 5 5 5 5 5 5 5 5 5 5 5 5 5 5 5 5 5 5 5 19 19 19 13 1 1 19 1 1 1 1 1 1 
5 5 5 5 5 5 5 5 5 5 5 5 5 5 5 5 5 5 5 5 5 5 5 5 5 5 5 5 5 5 5 5 5 5 5 5 5 5 5 5 5 5 5 5 5 1 1 1 1 1 
