17 17 17 17 17 17 17 17 17 17 17 17 17 17 17 17 17 17 17 17 17 17 17 17 17 17 17 17 17 17 17 17 17 17 17 17 17 17 17 17 17 17 17 17 17 17 17 17 17 17 
17 17 17 17 17 17 17 17 17 17 17 17 2 2 2 2 2 17 17 17 17 17 17 17 17 17 17 17 17 17 17 17 17 17 17 17 17 17 17 17 17 17 17 17 17 17 17 17 17 17 
17 17 17 17 2 2 2 0 2 2 17 17 2 2 17 17 2 17 17 17 17 17 17 17 17 17 17 13 17 17 17 17 17 17 17 17 17 17 17 17 17 17 17 17 17 17 17 17 17 17 
17 17 17 17 2 2 2 2 2 2 11 2 2 2 17 17 2 17 17 17 17 17 17 17 17 17 2 2 2 2 2 2 2 17 17 17 17 17 17 17 17 17 17 17 17 17 17 17 17 17 
17 17 17 13 2 2 2 2 2 2 17 17 2 2 2 2 2 17 17 17 17 17 17 17 17 17 2 2 2 2 2 2 2 13 17 17 17 17 17 17 17 17 17 17 17 17 17 17 17 17 
17 17 17 17 2 2 2 2 2 2 17 17 2 2 2 2 2 17 17 17 17 17 17 17 17 17 2 2 2 0 2 2 2 17 17 17 13 17 17 17 17 17 17 28 17 17 17 17 17 17 
17 17 2 2 2 2 2 2 2 2 17 17 17 17 17 17 17 17 17 13 2 2 2 2 2 2 2 2 2 0 2 2 2 2 2 2 2 2 2 2 17 17 2 2 2 2 2 17 17 17 
17 17 2 2 2 2 2 2 2 2 13 17 17 17 17 17 17 17 17 17 2 2 2 2 2 2 2 2 2 0 2 2 2 2 2 2 2 2 2 2 2 11 2 2 2 2 2 17 17 17 
17 17 2 2 2 2 2 2 2 2 17 17 17 2 2 2 2 2 2 17 2 2 2 2 2 2 2 2 2 0 2 2 2 2 2 2 2 2 2 2 2 11 2 2 2 2 2 17 17 17 
17 17 2 2 2 2 2 2 2 2 17 17 17 2 2 2 2 2 2 17 2 2 2 2 1 1 2 2 2 0 2 2 2 1 1 2 2 2 2 2 2 11 2 2 2 2 2 17 17 17 
17 17 2 2 2 2 2 2 2 2 2 2 17 2 2 17 17 2 2 17 17 17 17 17 1 1 2 2 2 0 2 2 2 1 1 2 2 2 2 2 2 11 2 2 2 2 2 23 17 17 
17 17 2 2 2 2 2 2 2 2 2 2 17 2 2 17 17 2 2 17 2 2 2 2 2 2 2 2 2 0 2 2 2 2 2 2 2 2 2 2 17 17 2 2 2 2 2 17 17 17 
17 17 17 17 2 2 2 2 2 2 2 2 17 2 2 17 17 2 2 17 2 2 2 2 2 2 2 2 2 0 13 2 2 2 2 2 2 2 2 2 28 17 17 17 13 17 17 17 17 17 
17 17 17 17 2 2 2 2 2 2 2 2 2 2 2 17 17 2 2 10 2 2 2 2 2 2 2 2 2 0 2 2 2 2 2 2 2 2 2 2 17 17 17 17 17 17 17 13 17 17 
17 17 17 13 2 2 2 2 2 2 2 2 17 2 2 17 17 2 2 17 2 2 2 2 1 23 2 2 2 0 2 2 2 1 1 2 2 2 2 2 17 17 17 17 0 0 0 0 0 0 
17 17 17 17 2 2 2 2 2 2 2 2 17 17 17 17 17 17 17 17 2 2 2 2 1 1 2 2 2 0 2 2 2 1 1 2 2 2 2 2 17 17 17 17 17 0 0 0 0 0 
17 17 17 17 2 2 2 2 2 2 2 2 17 17 17 17 17 17 17 13 2 2 2 2 2 2 2 2 2 0 2 2 2 2 2 2 2 2 2 2 13 17 0 17 17 0 18 18 18 18 
17 17 17 17 17 17 17 11 17 17 17 17 17 17 17 17 17 17 17 17 2 2 2 2 2 2 2 2 2 0 2 2 2 2 2 2 2 2 2 2 17 17 0 0 0 18 18 18 18 18 
17 2 2 2 2 2 2 2 2 2 2 2 17 17 17 17 17 17 17 17 17 17 17 17 17 17 17 17 17 0 17 17 17 17 17 17 17 17 11 17 17 17 0 18 18 18 18 18 18 18 
13 2 2 2 2 2 2 2 2 2 2 2 17 17 17 17 17 17 17 17 17 17 17 17 17 17 17 17 17 0 17 17 17 17 17 17 17 0 0 0 0 18 18 18 18 18 18 18 18 18 
17 2 2 2 2 2 2 2 2 2 2 2 13 17 17 17 17 17 17 17 17 17 17 17 17 17 17 17 17 0 17 17 17 17 17 17 17 18 18 18 18 18 18 18 18 23 19 19 19 19 
17 17 17 17 2 2 2 2 2 2 2 2 17 17 17 17 17 17 17 17 17 17 17 17 17 17 17 17 17 11 17 17 17 17 17 17 13 20 18 18 18 18 18 18 18 18 18 18 1 19 
17 17 17 17 2 2 2 2 2 2 2 2 17 17 17 17 17 17 17 17 17 17 17 17 0 0 0 0 0 0 5 5 1 1 1 19 1 20 20 18 18 18 18 18 18 18 18 18 19 1 
17 17 17 17 2 2 2 2 2 2 2 2 17 17 17 17 17 17 17 17 17 17 17 0 0 0 0 18 18 5 5 5 18 18 1 19 1 20 20 20 18 18 18 18 18 18 18 18 13 1 
17 2 2 2 2 2 2 2 2 2 2 20 17 17 17 17 17 17 17 17 17 17 0 0 0 18 18 18 5 5 5 18 18 18 1 1 1 1 1 20 20 18 18 18 18 18 18 18 1 19 
17 2 2 2 2 2 2 2 2 2 2 20 17 17 17 17 17 17 17 17 1 13 0 0 18 18 18 18 5 5 18 18 18 18 1 18 18 20 20 20 20 18 18 18 18 18 18 18 1 1 
17 2 2 2 2 2 2 2 2 2 20 20 17 17 17 17 17 17 17 1 19 1 0 18 18 18 18 18 18 18 18 18 18 18 10 18 18 20 1 1 20 20 18 18 18 18 18 1 1 1 
17 2 2 17 17 2 2 2 2 20 20 20 17 17 17 17 17 17 1 19 19 19 19 18 18 18 18 18 18 18 18 18 18 18 1 18 20 20 19 1 1 20 20 18 18 18 1 1 1 19 
17 2 2 17 17 2 2 20 20 20 20 17 17 17 17 17 17 1 19 13 1 1 19 19 18 18 18 18 18 18 18 18 18 18 1 20 20 20 19 19 1 19 1 1 1 1 1 1 19 19 
17 2 2 2 2 2 20 20 20 20 17 17 17 17 17 17 1 19 0 0 0 0 1 19 19 1 18 18 18 18 18 18 1 13 1 20 20 20 1 1 19 19 1 1 1 13 1 1 19 1 
17 2 2 20 20 20 20 20 20 17 17 17 17 17 17 1 19 0 0 0 18 18 18 1 19 19 1 18 18 18 18 18 1 1 1 20 20 20 19 19 1 1 20 20 20 20 20 1 1 1 
17 17 17 17 17 17 13 17 17 17 17 17 17 17 1 1 19 0 0 18 18 18 18 18 18 18 18 18 18 18 18 18 19 19 1 20 20 20 20 1 20 20 20 20 20 20 20 20 20 1 
17 17 17 17 17 17 17 17 17 17 17 17 17 1 19 19 19 0 18 18 18 18 18 18 18 18 18 18 18 13 18 18 1 19 1 20 20 20 20 11 20 20 20 20 20 20 20 20 20 13 
17 17 17 17 17 17 17 17 17 17 17 17 5 19 5 5 5 0 18 18 18 18 18 18 18 18 18 18 18 18 18 20 13 19 1 20 20 20 20 1 20 20 20 20 1 1 20 20 20 1 
17 17 17 17 17 17 17 17 17 17 17 5 5 5 5 5 5 18 18 18 18 18 18 18 18 18 18 18 18 18 20 20 1 1 19 19 1 1 1 1 20 20 20 20 20 20 20 20 20 1 
17 17 17 17 17 17 17 17 17 17 5 5 5 5 5 19 1 1 11 1 1 1 1 1 1 1 1 1 1 1 1 1 19 19 1 1 1 1 1 1 20 20 20 20 20 20 20 20 20 1 
17 17 17 17 17 17 17 17 17 5 5 5 5 5 1 1 1 18 18 18 1 1 19 1 1 19 19 1 1 1 19 19 19 19 1 19 19 19 19 1 1 20 20 20 20 20 20 20 20 1 
17 17 17 17 17 17 17 17 0 0 5 5 5 1 19 18 18 18 18 18 18 18 1 1 1 1 1 1 1 13 1 1 19 1 19 19 1 1 19 1 1 1 1 1 1 20 20 20 1 1 
17 17 17 17 17 17 17 0 0 0 0 18 5 19 1 18 18 18 18 18 18 18 18 18 18 18 18 18 20 20 20 1 1 1 1 1 1 19 19 19 1 19 19 1 1 20 20 20 1 19 
17 17 17 17 17 17 0 0 18 13 18 18 18 1 18 18 18 18 1 18 18 18 18 18 18 18 20 20 20 20 20 1 1 1 19 19 19 1 1 1 1 1 1 1 1 20 20 20 1 1 
17 17 17 17 17 0 0 18 18 18 18 18 18 10 18 18 18 1 1 1 18 18 18 18 18 20 20 20 20 20 20 1 1 1 1 1 19 19 1 19 1 1 1 1 1 20 20 20 1 1 
17 17 17 17 0 0 18 18 18 18 18 18 18 1 18 18 18 18 1 18 18 18 1 1 1 19 19 1 1 11 1 1 13 1 1 1 1 19 19 1 19 19 13 19 1 20 20 20 13 19 
17 17 17 0 0 18 18 18 18 18 18 18 18 19 1 18 18 18 18 18 18 20 13 1 1 19 1 1 18 18 18 18 18 18 1 1 19 19 18 18 18 0 0 19 1 20 20 20 1 19 
17 17 0 0 18 18 18 18 18 18 18 18 18 1 19 18 18 18 20 20 20 20 1 19 1 1 1 1 0 18 18 18 18 18 18 18 18 18 18 18 18 18 0 0 1 20 20 20 1 1 
17 5 0 18 18 18 18 18 18 18 18 18 18 1 1 13 1 20 20 20 1 1 1 1 5 1 1 13 0 0 18 18 18 18 18 18 18 18 18 18 18 18 18 0 11 20 20 20 19 1 
5 5 0 18 18 18 18 18 18 18 18 18 5 5 1 1 19 1 28 1 19 1 1 5 5 5 1 1 0 0 0 0 18 18 19 19 1 19 18 18 18 18 18 0 1 20 20 1 19 1 
5 5 18 17 17 18 18 13 18 18 18 5 5 5 5 5 5 1 1 19 1 1 5 5 5 5 1 19 19 22 19 1 1 19 19 1 1 1 18 18 18 18 0 0 1 19 1 1 1 1 
5 5 18 17 17 18 18 18 18 5 5 5 5 5 5 5 5 5 5 5 5 5 5 5 5 5 5 5 5 5 5 5 5 5 5 5 5 19 18 18 18 0 0 19 19 19 19 1 19 19 
5 5 18 18 18 18 18 5 5 5 5 5 5 5 5 5 5 5 5 5 5 5 5 5 5 5 5 5 5 5 5 5 5 5 5 5 5 19 19 19 13 1 1 19 1 19 19 1 1 1 
5 5 5 5 5 5 5 5 5 5 5 5 5 5 5 5 5 5 5 5 5 5 5 5 5 5 5 5 5 5 5 5 5 5 5 5 5 5 5 5 5 5 5 5 5 1 19 19 19 1 
